MorseEncoderFSM	KEYWORD1
MorseEncoder	KEYWORD1

MAIN	LITERAL1 
CHR	LITERAL1 
DASH	LITERAL1 
DOT	LITERAL1 
SHORT_DELAY	LITERAL1 
CHAR_DELAY	LITERAL1 
WORD_DELAY	LITERAL1 

updateSignal	KEYWORD2
mainState	KEYWORD2
charState	KEYWORD2
dotState	KEYWORD2
dashState	KEYWORD2
shortDelayState	KEYWORD2
charDelayState	KEYWORD2
wordDelayState	KEYWORD2
begin	KEYWORD2
update	KEYWORD2
send	KEYWORD2
getSignal	KEYWORD2